R  640 640   

NO tex/safi.xpm         
SO tex/tigrex.xpm
WE tex/gog.xpm
EA tex/akantor.xpm

S  tex/gore.xpm

C  80, 80, 80     
F  110, 110, 110

1111111111111111
111111111111111111
 
   111111111111
    1000000200011
     1100000110001
    10000001  101  1111
     100020011000110001
1111100002000000000001  111111111111
100000000200011111111   100001
11111100000010000111    100001
      100N01 1021       111111
      100001 1001
  11111000011101   11111
11000000000000001
1111111111111111
1 
1111
